###################################
#   #         #   #   #     # # #E#
# # ### ######### # # # ### # # # #
# # #   #           #   #         #
# # # ### ######### ##### ### ### #
# # # # #   #     #   #     # # # #
### # # ### # # ### # # # ### # ###
#             #   # # # # #   #   #
###################################
